
NO assets/north_wall.xpm
SO assets/south_wall.xpm
WE assets/west_wall.xpm
EA assets/east_wall.xpm

F 250,250,110
C 100,25,144

111111111111
100000000001
111111N11111
111100000011
111100000011111111111111
111100000000000000000001
111111111111111111110001
100000000000000000000001
100000000000000000000001
100000000000000000000001
100000000000000000000001
100000000000000000000001
111111111111111111111111