NO assets/north_wall.xpm
SO assets/south_wall.xpm
WE assets/west_wall.xpm
EA assets/east_wall.xpm

F 255,215,115
C 200,25,250

11111111111111111              11111111111
100000000000000001             10000000001
10000001111110000011            10000000001
11000001     10000001           11000000011
  100001     1000001             10000011
  100001     1000001             1000001
  10000111111000001              1000001
  1000000000000011               1000001
  10000111111000001              1000001
  100001     1000001             1000001
  100001     1000001             1000001
  100001     1000001             1000001         111111
11000001     100000011  11111  110000001111111111000001
10000001     100000000110000011000000000000000000000001
1N000001     1000000000000000000000000000000000000000011
11111111     111111111111111111111111111111111111111111